________________________________________
|--------------------------------------|
|--------------------------------------|
|--------------------------------------|
|--------------------------------------|
|--------------------------------------|
|--------------------------------------|
|-------------------S------------------|
|--------------------------------------|
|----*****-----**********-----*****----|
|--------------------------------------|
|--------------------------------------|
|------------------S-------------------|
|--------------------------------------|
|--------------------------------------|
|-----------*******--*******-----------|
|--------------------------------------|
|--------------------------------------|
|------------------M-------------------|
|--------------------------------------|
|--------------------------------------|
|----*****------********------*****----|
|--------------------------------------|
|--------------------------------------|
|------------------M-------------------|
|--------------------------------------|
|--------------------------------------|
|----********-----******-----******----|
|--------------------------------------|
|--------------------------------------|
|--------------------------------------|
|--H-----------------------------------|
|--------------------------------------|
****************************************